_____T______C__T_____b________T____C___A
_T_____H___________C________T_____H_____
_____T______C__R____H___R_______T_______
________________________________________
________________________________________
________________________________________
________________________________________
_____C______R___C_____R___C_____________
___________R__________C___________C_____
__C_________R_______R______R____________
