........................................
........................................
........................................
........................................
........................................
........................................
........................................
.............,,,,,,,,,,,,,,,............
..........,,,,,,,,,,,,,,,,,,,,..........
........,,,,,,,,,,,,,,,,,,,,,,,.........
......,,,,,,,,,,,,,,,,,,,,,,,,,,,,......
....,,,,,,,,,,,,,,,,,,,,,,,,,,,,,,,,....
..,,,,,,,,,,,,,,,,,,,,,,,,,,,,,,,,,,,,..
,,,,,,,,,,,,,,,,,,~~~~~,,,,,,,,,,,,,,,,,
,,,,,,,,,,,,,,,~~~~~~~~~~~,,,,,,,,,,,,,,
,,,,,,,,,,,,~~~~~~~~~~~~~~~~~,,,,,,,,,,,
,,,,,,,,,,~~~~~~~~~~~~~~~~~~~~~~,,,,,,,,
,,,,,,,,~~~~~~~~~~~~~~~~~~~~~~~~~,,,,,,,
,,,,,,,~~~~~~~~~~~~~~~~~~~~~~~~~~~,,,,,,
,,,,,,~~~~~~~~~~~~~~~~~~~~~~~~~~~~~,,,,,
,,,,,,~~~~~~~~~~~~~~~~~~~~~~~~~~~~~,,,,,
,,,,,,~~~~~~~~~~~~~~~~~~~~~~~~~~~~~,,,,,
,,,,,,,~~~~~~~~~~~~~~~~~~~~~~~~~~~,,,,,,
,,,,,,,~~~~~~~~~~~~~~~~~~~~~~~~~~,,,,,,,
,,,,,,,,~~~~~~~~~~~~~~~~~~~~~~~~,,,,,,,,
,,,,,,,,,,,~~~~~~~~~~~~~~~~~~~,,,,,,,,,,
,,,,,,,,,,,,,,~~~~~~~~~~~~,,,,,,,,,,,,,,
,,,,,,,,,,,,,,,,,,~~~~~,,,,,,,,,,,,,,,,,
..,,,,,,,,,,,,,,,,,,,,,,,,,,,,,,,,,,,,,.
....,,,,,,,,,,,,,,,,,,,,,,,,,,,,,,,,,...
......,,,,,,,,,,,,,,,,,,,,,,,,,,,,,.....
.........,,,,,,,,,,,,,,,,,,,,,,,........
..........,,,,,,,,,,,,,,,,,,,,,.........
.............,,,,,,,,,,,,,,,............
........................................
........................................
........................................
........................................
........................................
........................................