,,,,,,,,,,,,,,,,,,,,,,,,,,,,,,,,,,,,,,,,
,,,,,,,,,,,,,,,,,,,,,,,,,,,,,,,,,,,,,,,,
,,,,,,,,,,,,,,,,,,,,,,,,,,,,,,,,,,,,,,,,
,,,,,,,,,,,,,,,,,,,,,,,,,,,,,,,,,,,,,,,,
,,,,,,,,,,,,,,,,,,,,,,,,,,,,,,,,,,,,,,,,
,,,,,,,,,,,,,,,,,,,,,,,,,,,,,,,,,,,,,,,,
,,,,,,,,,,,,,,,,,,,,,,,,,,,,,,,,,,,,,,~~
,,,,,,,,,,,,,,,,,,,,,,,,,,,,,,,,,,,,~~~~
,,,,,,,,,,,,,,,,,,,,,,,,,,,,,,,,,,~~~~~~
~~,,,,,,,,,,,,,,,,,,,,,,,,,,,,,~~~~~~~,,
~~~~,,,,,,,,,,,,,,,,,,,,,,,,~~~~~~~~,,,,
~~~~~~,,,,,,,,,,,,,,,,,,~~~~~~~~~,,,,,,,
,,,~~~~~~~,,,,,,,,,,~~~~~~~~~,,,,,,,,,,,
,,,,,~~~~~~~~,,,,~~~~~~~~,,,,,,,,,,,,,,,
,,,,,,,~~~~~~~~~~~~~~~,,,,,,,,,,,,,,,,,,
,,,,,,,,,,~~~~~~~~,,,,,,,,,,,,,,,,,,,,,,
,,,,,,,,,,,,,,,,,,,,,,,,,,,,,,,,,,,,,,,,
,,,,,,,,,,,,,,,,,,,,,,,,,,,,,,,,,,,,,,,,
,,,,,,,,,,,,,,,,,,,,,,,,,,,,,,,,,,,,,,,,
,,,,,,,,,,,,,,,,,,,,,,,,,,,,,,,,,,,,,,,,
,,,,,,,,,,,,,,,,,,,,,,,,,,,,,,,,,,,,,,,,
,,,,,,,,,,,,,,,,,,,,,,,,,,,,,,,,,,,,,,,,
,,,,,,,,,,,,,,,,,,,,,,,,,,,,,,,,,,,,,,,,
,,,,,,,,,,,,,,,,,,,,,,,,,,,,,,,,,,,.....
,,,,,,,,,,,,,,,,,,,,,,,,,,,,,,,.........
,,,,,,,,,,,,,,,,,,,,,,,,,...............
,,,,,,,,,,,,,,,,,,......................
,,,,,,,,,,,,,,..........................
,,,,,,,,,,,,,,..........................
,,,,,,,,,,,.............................
,,,,,,,,,,,.............................
,,,,,,,,,,,,,...........................
,,,,,,,,,,,,,,,,........................
,,,,,,,,,,,,,,,,,.......................
,,,,,,,,,,,,,,,,,,......................
,,,,,,,,,,,,,,,,,,,,....................
,,,,,,,,,,,,,,,,,,,,....................
,,,,,,,,,,,,,,,,,,,.....................
,,,,,,,,,,,,,,,,,,......................
,,,,,,,,,,,,,,,,,.......................